###########
ES...#...SE
####B##B###
#B.B.ES..B#
###.##R#..#
#B.S#B.EEB# 
#R.###B..S#
#..RBS.B#S#
#E.#.E###B#
#BS.BRG..S#
###########