##RREEERR##
#.M.....M.#
R.B..B..B.R
E.........E
E.M..S..M.G
E.........E
R.B..B..B.R
#.M.....M.#
##RREEERR##