###########
ES...#...SE
####B##B###
#B.B.ES..B#
###.##R#..#
#B.S#B.EEB# 
#R.###B..S#
#..RB..B#.#
#E.#.E###S#
#B..BRG..B#
###########