#######
##..M##
#S...M#
#S...MG
#S...M#
##..M##
#######