#############
#S.AEA.AEA.S#
#...A.B.....#
#A.A#A.A#A.A#
##.E##.###A##
#A.A#A.AEA.A#
#.B...G...B.#
#A.AEA.A#A.A#
##A###.E##.E#
#A.A#A.AEA.A#
#.....B.A...#
#S.AEA.A#A.S#
#############
