#########
#S......#
#.E###.E#
#..R.B..#
#E.###E.#
#......G#
#########